LnID,DID,BLID,FLID,BNID,FNID,JCT,BLID2,BLID3,BLID4,FLID2,FLID3,FLID4,ClossID,Span,LCnt,Lno,LaneType,LimitVel,RefVel,RoadSecID,LaneChgFG,LinkWAID
1,1,0,120,1,2,0,0,0,0,0,0,0,0,1,1,1,0,30,30,0,0,0
2,2,17,0,4,3,0,0,0,0,0,0,0,0,1,1,1,0,30,30,0,0,0
17,17,18,2,20,4,0,0,0,0,0,0,0,0,1,1,1,0,30,30,0,0,0
18,18,19,17,21,20,0,0,0,0,0,0,0,0,1,1,1,0,30,30,0,0,0
19,19,20,18,22,21,0,0,0,0,0,0,0,0,1,1,1,0,30,30,0,0,0
20,20,21,19,23,22,0,0,0,0,0,0,0,0,1,1,1,0,30,30,0,0,0
21,21,22,20,24,23,0,0,0,0,0,0,0,0,1,1,1,0,30,30,0,0,0
22,22,23,21,25,24,0,0,0,0,0,0,0,0,1,1,1,0,30,30,0,0,0
23,23,24,22,26,25,0,0,0,0,0,0,0,0,1,1,1,0,30,30,0,0,0
24,24,25,23,27,26,0,0,0,0,0,0,0,0,1,1,1,0,30,30,0,0,0
25,25,26,24,28,27,0,0,0,0,0,0,0,0,1,1,1,0,30,30,0,0,0
26,26,27,25,29,28,0,0,0,0,0,0,0,0,1,1,1,0,30,30,0,0,0
27,27,28,26,30,29,0,0,0,0,0,0,0,0,1,1,1,0,30,30,0,0,0
28,28,29,27,31,30,0,0,0,0,0,0,0,0,1,1,1,0,30,30,0,0,0
29,29,30,28,32,31,0,0,0,0,0,0,0,0,1,1,1,0,30,30,0,0,0
30,30,31,29,33,32,0,0,0,0,0,0,0,0,1,1,1,0,30,30,0,0,0
31,31,32,30,34,33,0,0,0,0,0,0,0,0,1,1,1,0,30,30,0,0,0
32,32,33,31,35,34,0,0,0,0,0,0,0,0,1,1,1,0,30,30,0,0,0
33,33,34,32,36,35,0,0,0,0,0,0,0,0,1,1,1,0,30,30,0,0,0
34,34,35,33,37,36,0,0,0,0,0,0,0,0,1,1,1,0,30,30,0,0,0
35,35,36,34,38,37,0,0,0,0,0,0,0,0,1,1,1,0,30,30,0,0,0
36,36,37,35,39,38,0,0,0,0,0,0,0,0,1,1,1,0,30,30,0,0,0
37,37,38,36,40,39,0,0,0,0,0,0,0,0,1,1,1,0,30,30,0,0,0
38,38,39,37,41,40,0,0,0,0,0,0,0,0,1,1,1,0,30,30,0,0,0
39,39,40,38,42,41,0,0,0,0,0,0,0,0,1,1,1,0,30,30,0,0,0
40,40,41,39,43,42,0,0,0,0,0,0,0,0,1,1,1,0,30,30,0,0,0
41,41,42,40,44,43,0,0,0,0,0,0,0,0,1,1,1,0,30,30,0,0,0
42,42,43,41,45,44,0,0,0,0,0,0,0,0,1,1,1,0,30,30,0,0,0
43,43,44,42,46,45,0,0,0,0,0,0,0,0,1,1,1,0,30,30,0,0,0
44,44,45,43,47,46,0,0,0,0,0,0,0,0,1,1,1,0,30,30,0,0,0
45,45,46,44,48,47,0,0,0,0,0,0,0,0,1,1,1,0,30,30,0,0,0
46,46,47,45,49,48,0,0,0,0,0,0,0,0,1,1,1,0,30,30,0,0,0
47,47,48,46,50,49,0,0,0,0,0,0,0,0,1,1,1,0,30,30,0,0,0
48,48,49,47,51,50,0,0,0,0,0,0,0,0,1,1,1,0,30,30,0,0,0
49,49,50,48,52,51,0,0,0,0,0,0,0,0,1,1,1,0,30,30,0,0,0
50,50,51,49,53,52,0,0,0,0,0,0,0,0,1,1,1,0,30,30,0,0,0
51,51,52,50,54,53,0,0,0,0,0,0,0,0,1,1,1,0,30,30,0,0,0
52,52,53,51,55,54,0,0,0,0,0,0,0,0,1,1,1,0,30,30,0,0,0
53,53,54,52,56,55,0,0,0,0,0,0,0,0,1,1,1,0,30,30,0,0,0
54,54,55,53,57,56,0,0,0,0,0,0,0,0,1,1,1,0,30,30,0,0,0
55,55,56,54,58,57,0,0,0,0,0,0,0,0,1,1,1,0,30,30,0,0,0
56,56,57,55,59,58,0,0,0,0,0,0,0,0,1,1,1,0,30,30,0,0,0
57,57,58,56,60,59,0,0,0,0,0,0,0,0,1,1,1,0,30,30,0,0,0
58,58,59,57,61,60,0,0,0,0,0,0,0,0,1,1,1,0,30,30,0,0,0
59,59,60,58,62,61,0,0,0,0,0,0,0,0,1,1,1,0,30,30,0,0,0
60,60,61,59,63,62,0,0,0,0,0,0,0,0,1,1,1,0,30,30,0,0,0
61,61,62,60,64,63,0,0,0,0,0,0,0,0,1,1,1,0,30,30,0,0,0
62,62,63,61,65,64,0,0,0,0,0,0,0,0,1,1,1,0,30,30,0,0,0
63,63,64,62,66,65,0,0,0,0,0,0,0,0,1,1,1,0,30,30,0,0,0
64,64,65,63,67,66,0,0,0,0,0,0,0,0,1,1,1,0,30,30,0,0,0
65,65,66,64,68,67,0,0,0,0,0,0,0,0,1,1,1,0,30,30,0,0,0
66,66,67,65,69,68,0,0,0,0,0,0,0,0,1,1,1,0,30,30,0,0,0
67,67,0,66,70,69,0,0,0,0,0,0,0,0,1,1,1,0,30,30,0,0,0
68,68,0,69,70,71,0,0,0,0,0,0,0,0,1,1,1,0,30,30,0,0,0
69,69,68,70,71,72,0,0,0,0,0,0,0,0,1,1,1,0,30,30,0,0,0
70,70,69,71,72,73,0,0,0,0,0,0,0,0,1,1,1,0,30,30,0,0,0
71,71,70,72,73,74,0,0,0,0,0,0,0,0,1,1,1,0,30,30,0,0,0
72,72,71,73,74,75,0,0,0,0,0,0,0,0,1,1,1,0,30,30,0,0,0
73,73,72,74,75,76,0,0,0,0,0,0,0,0,1,1,1,0,30,30,0,0,0
74,74,73,75,76,77,0,0,0,0,0,0,0,0,1,1,1,0,30,30,0,0,0
75,75,74,76,77,78,0,0,0,0,0,0,0,0,1,1,1,0,30,30,0,0,0
76,76,75,77,78,79,0,0,0,0,0,0,0,0,1,1,1,0,30,30,0,0,0
77,77,76,78,79,80,0,0,0,0,0,0,0,0,1,1,1,0,30,30,0,0,0
78,78,77,79,80,81,0,0,0,0,0,0,0,0,1,1,1,0,30,30,0,0,0
79,79,78,80,81,82,0,0,0,0,0,0,0,0,1,1,1,0,30,30,0,0,0
80,80,79,81,82,83,0,0,0,0,0,0,0,0,1,1,1,0,30,30,0,0,0
81,81,80,82,83,84,0,0,0,0,0,0,0,0,1,1,1,0,30,30,0,0,0
82,82,81,83,84,85,0,0,0,0,0,0,0,0,1,1,1,0,30,30,0,0,0
83,83,82,84,85,86,0,0,0,0,0,0,0,0,1,1,1,0,30,30,0,0,0
84,84,83,85,86,87,0,0,0,0,0,0,0,0,1,1,1,0,30,30,0,0,0
85,85,84,86,87,88,0,0,0,0,0,0,0,0,1,1,1,0,30,30,0,0,0
86,86,85,87,88,89,0,0,0,0,0,0,0,0,1,1,1,0,30,30,0,0,0
87,87,86,88,89,90,0,0,0,0,0,0,0,0,1,1,1,0,30,30,0,0,0
88,88,87,89,90,91,0,0,0,0,0,0,0,0,1,1,1,0,30,30,0,0,0
89,89,88,90,91,92,0,0,0,0,0,0,0,0,1,1,1,0,30,30,0,0,0
90,90,89,91,92,93,0,0,0,0,0,0,0,0,1,1,1,0,30,30,0,0,0
91,91,90,92,93,94,0,0,0,0,0,0,0,0,1,1,1,0,30,30,0,0,0
92,92,91,93,94,95,0,0,0,0,0,0,0,0,1,1,1,0,30,30,0,0,0
93,93,92,94,95,96,0,0,0,0,0,0,0,0,1,1,1,0,30,30,0,0,0
94,94,93,95,96,97,0,0,0,0,0,0,0,0,1,1,1,0,30,30,0,0,0
95,95,94,96,97,98,0,0,0,0,0,0,0,0,1,1,1,0,30,30,0,0,0
96,96,95,97,98,99,0,0,0,0,0,0,0,0,1,1,1,0,30,30,0,0,0
97,97,96,98,99,100,0,0,0,0,0,0,0,0,1,1,1,0,30,30,0,0,0
98,98,97,99,100,101,0,0,0,0,0,0,0,0,1,1,1,0,30,30,0,0,0
99,99,98,100,101,102,0,0,0,0,0,0,0,0,1,1,1,0,30,30,0,0,0
100,100,99,101,102,103,0,0,0,0,0,0,0,0,1,1,1,0,30,30,0,0,0
101,101,100,102,103,104,0,0,0,0,0,0,0,0,1,1,1,0,30,30,0,0,0
102,102,101,103,104,105,0,0,0,0,0,0,0,0,1,1,1,0,30,30,0,0,0
103,103,102,104,105,106,0,0,0,0,0,0,0,0,1,1,1,0,30,30,0,0,0
104,104,103,105,106,107,0,0,0,0,0,0,0,0,1,1,1,0,30,30,0,0,0
105,105,104,106,107,108,0,0,0,0,0,0,0,0,1,1,1,0,30,30,0,0,0
106,106,105,107,108,109,0,0,0,0,0,0,0,0,1,1,1,0,30,30,0,0,0
107,107,106,108,109,110,0,0,0,0,0,0,0,0,1,1,1,0,30,30,0,0,0
108,108,107,109,110,111,0,0,0,0,0,0,0,0,1,1,1,0,30,30,0,0,0
109,109,108,110,111,112,0,0,0,0,0,0,0,0,1,1,1,0,30,30,0,0,0
110,110,109,111,112,113,0,0,0,0,0,0,0,0,1,1,1,0,30,30,0,0,0
111,111,110,112,113,114,0,0,0,0,0,0,0,0,1,1,1,0,30,30,0,0,0
112,112,111,113,114,115,0,0,0,0,0,0,0,0,1,1,1,0,30,30,0,0,0
113,113,112,114,115,116,0,0,0,0,0,0,0,0,1,1,1,0,30,30,0,0,0
114,114,113,115,116,117,0,0,0,0,0,0,0,0,1,1,1,0,30,30,0,0,0
115,115,114,116,117,118,0,0,0,0,0,0,0,0,1,1,1,0,30,30,0,0,0
116,116,115,117,118,119,0,0,0,0,0,0,0,0,1,1,1,0,30,30,0,0,0
117,117,116,118,119,120,0,0,0,0,0,0,0,0,1,1,1,0,30,30,0,0,0
118,118,117,119,120,121,0,0,0,0,0,0,0,0,0.795,1,1,0,30,30,0,0,0
119,119,118,0,121,122,0,0,0,0,0,0,0,0,0.795,1,1,0,30,30,0,0,0
120,120,1,121,2,123,0,0,0,0,0,0,0,0,1,1,1,0,30,30,0,0,0
121,121,120,122,123,124,0,0,0,0,0,0,0,0,1,1,1,0,30,30,0,0,0
122,122,121,123,124,125,0,0,0,0,0,0,0,0,1,1,1,0,30,30,0,0,0
123,123,122,124,125,126,0,0,0,0,0,0,0,0,1,1,1,0,30,30,0,0,0
124,124,123,125,126,127,0,0,0,0,0,0,0,0,1,1,1,0,30,30,0,0,0
125,125,124,126,127,128,0,0,0,0,0,0,0,0,1,1,1,0,30,30,0,0,0
126,126,125,127,128,129,0,0,0,0,0,0,0,0,1,1,1,0,30,30,0,0,0
127,127,126,128,129,130,0,0,0,0,0,0,0,0,1,1,1,0,30,30,0,0,0
128,128,127,129,130,131,0,0,0,0,0,0,0,0,1,1,1,0,30,30,0,0,0
129,129,128,130,131,132,0,0,0,0,0,0,0,0,1,1,1,0,30,30,0,0,0
130,130,129,131,132,133,0,0,0,0,0,0,0,0,1,1,1,0,30,30,0,0,0
131,131,130,132,133,134,0,0,0,0,0,0,0,0,1,1,1,0,30,30,0,0,0
132,132,131,133,134,135,0,0,0,0,0,0,0,0,1,1,1,0,30,30,0,0,0
133,133,132,134,135,136,0,0,0,0,0,0,0,0,1,1,1,0,30,30,0,0,0
134,134,133,135,136,137,0,0,0,0,0,0,0,0,1,1,1,0,30,30,0,0,0
135,135,134,136,137,138,0,0,0,0,0,0,0,0,1,1,1,0,30,30,0,0,0
136,136,135,137,138,139,0,0,0,0,0,0,0,0,1,1,1,0,30,30,0,0,0
137,137,136,138,139,140,0,0,0,0,0,0,0,0,1,1,1,0,30,30,0,0,0
138,138,137,139,140,141,0,0,0,0,0,0,0,0,1,1,1,0,30,30,0,0,0
139,139,138,140,141,142,0,0,0,0,0,0,0,0,1,1,1,0,30,30,0,0,0
140,140,139,141,142,143,0,0,0,0,0,0,0,0,1,1,1,0,30,30,0,0,0
141,141,140,142,143,144,0,0,0,0,0,0,0,0,1,1,1,0,30,30,0,0,0
142,142,141,143,144,145,0,0,0,0,0,0,0,0,1,1,1,0,30,30,0,0,0
143,143,142,144,145,146,0,0,0,0,0,0,0,0,1,1,1,0,30,30,0,0,0
144,144,143,145,146,147,0,0,0,0,0,0,0,0,1,1,1,0,30,30,0,0,0
145,145,144,146,147,148,0,0,0,0,0,0,0,0,1,1,1,0,30,30,0,0,0
146,146,145,147,148,149,0,0,0,0,0,0,0,0,1,1,1,0,30,30,0,0,0
147,147,146,148,149,150,0,0,0,0,0,0,0,0,1,1,1,0,30,30,0,0,0
148,148,147,149,150,151,0,0,0,0,0,0,0,0,1,1,1,0,30,30,0,0,0
149,149,148,150,151,152,0,0,0,0,0,0,0,0,1,1,1,0,30,30,0,0,0
150,150,149,151,152,153,0,0,0,0,0,0,0,0,1,1,1,0,30,30,0,0,0
151,151,150,152,153,154,0,0,0,0,0,0,0,0,1,1,1,0,30,30,0,0,0
152,152,151,153,154,155,0,0,0,0,0,0,0,0,1,1,1,0,30,30,0,0,0
153,153,152,154,155,156,0,0,0,0,0,0,0,0,1,1,1,0,30,30,0,0,0
154,154,153,155,156,157,0,0,0,0,0,0,0,0,1,1,1,0,30,30,0,0,0
155,155,154,156,157,158,0,0,0,0,0,0,0,0,1,1,1,0,30,30,0,0,0
156,156,155,157,158,159,0,0,0,0,0,0,0,0,1,1,1,0,30,30,0,0,0
157,157,156,158,159,160,0,0,0,0,0,0,0,0,1,1,1,0,30,30,0,0,0
158,158,157,159,160,161,0,0,0,0,0,0,0,0,1,1,1,0,30,30,0,0,0
159,159,158,160,161,162,0,0,0,0,0,0,0,0,1,1,1,0,30,30,0,0,0
160,160,159,161,162,163,0,0,0,0,0,0,0,0,1,1,1,0,30,30,0,0,0
161,161,160,162,163,164,0,0,0,0,0,0,0,0,1,1,1,0,30,30,0,0,0
162,162,161,163,164,165,0,0,0,0,0,0,0,0,1,1,1,0,30,30,0,0,0
163,163,162,164,165,166,0,0,0,0,0,0,0,0,1,1,1,0,30,30,0,0,0
164,164,163,165,166,167,0,0,0,0,0,0,0,0,1,1,1,0,30,30,0,0,0
165,165,164,166,167,168,0,0,0,0,0,0,0,0,1,1,1,0,30,30,0,0,0
166,166,165,167,168,169,0,0,0,0,0,0,0,0,1,1,1,0,30,30,0,0,0
167,167,166,168,169,170,0,0,0,0,0,0,0,0,1,1,1,0,30,30,0,0,0
168,168,167,169,170,171,0,0,0,0,0,0,0,0,1,1,1,0,30,30,0,0,0
169,169,168,170,171,172,0,0,0,0,0,0,0,0,1,1,1,0,30,30,0,0,0
170,170,169,171,172,173,0,0,0,0,0,0,0,0,1,1,1,0,30,30,0,0,0
171,171,170,172,173,174,0,0,0,0,0,0,0,0,1,1,1,0,30,30,0,0,0
172,172,171,173,174,175,0,0,0,0,0,0,0,0,1,1,1,0,30,30,0,0,0
173,173,172,174,175,176,0,0,0,0,0,0,0,0,1,1,1,0,30,30,0,0,0
174,174,173,175,176,177,0,0,0,0,0,0,0,0,1,1,1,0,30,30,0,0,0
175,175,174,176,177,178,0,0,0,0,0,0,0,0,1,1,1,0,30,30,0,0,0
176,176,175,177,178,179,0,0,0,0,0,0,0,0,1,1,1,0,30,30,0,0,0
177,177,176,178,179,180,0,0,0,0,0,0,0,0,1,1,1,0,30,30,0,0,0
178,178,177,179,180,181,0,0,0,0,0,0,0,0,1,1,1,0,30,30,0,0,0
179,179,178,180,181,182,0,0,0,0,0,0,0,0,1,1,1,0,30,30,0,0,0
180,180,179,181,182,183,0,0,0,0,0,0,0,0,1,1,1,0,30,30,0,0,0
181,181,180,182,183,184,0,0,0,0,0,0,0,0,1,1,1,0,30,30,0,0,0
182,182,181,183,184,185,0,0,0,0,0,0,0,0,1,1,1,0,30,30,0,0,0
183,183,182,184,185,186,0,0,0,0,0,0,0,0,1,1,1,0,30,30,0,0,0
184,184,183,185,186,187,0,0,0,0,0,0,0,0,1,1,1,0,30,30,0,0,0
185,185,184,186,187,188,0,0,0,0,0,0,0,0,1,1,1,0,30,30,0,0,0
186,186,185,187,188,189,0,0,0,0,0,0,0,0,1,1,1,0,30,30,0,0,0
187,187,186,188,189,190,0,0,0,0,0,0,0,0,1,1,1,0,30,30,0,0,0
188,188,187,189,190,191,0,0,0,0,0,0,0,0,1,1,1,0,30,30,0,0,0
189,189,188,190,191,192,0,0,0,0,0,0,0,0,1,1,1,0,30,30,0,0,0
190,190,189,191,192,193,0,0,0,0,0,0,0,0,1,1,1,0,30,30,0,0,0
191,191,190,192,193,194,0,0,0,0,0,0,0,0,1,1,1,0,30,30,0,0,0
192,192,191,193,194,195,0,0,0,0,0,0,0,0,1,1,1,0,30,30,0,0,0
193,193,192,194,195,196,0,0,0,0,0,0,0,0,1,1,1,0,30,30,0,0,0
194,194,193,195,196,197,0,0,0,0,0,0,0,0,1,1,1,0,30,30,0,0,0
195,195,194,196,197,198,0,0,0,0,0,0,0,0,1,1,1,0,30,30,0,0,0
196,196,195,197,198,199,0,0,0,0,0,0,0,0,1,1,1,0,30,30,0,0,0
197,197,196,198,199,200,0,0,0,0,0,0,0,0,1,1,1,0,30,30,0,0,0
198,198,197,199,200,201,0,0,0,0,0,0,0,0,1,1,1,0,30,30,0,0,0
199,199,198,200,201,202,0,0,0,0,0,0,0,0,1,1,1,0,30,30,0,0,0
200,200,199,201,202,203,0,0,0,0,0,0,0,0,1,1,1,0,30,30,0,0,0
201,201,200,202,203,204,0,0,0,0,0,0,0,0,1,1,1,0,30,30,0,0,0
202,202,201,203,204,205,0,0,0,0,0,0,0,0,1,1,1,0,30,30,0,0,0
203,203,202,204,205,206,0,0,0,0,0,0,0,0,1,1,1,0,30,30,0,0,0
204,204,203,205,206,207,0,0,0,0,0,0,0,0,1,1,1,0,30,30,0,0,0
205,205,204,206,207,208,0,0,0,0,0,0,0,0,1,1,1,0,30,30,0,0,0
206,206,205,207,208,209,0,0,0,0,0,0,0,0,1,1,1,0,30,30,0,0,0
207,207,206,208,209,210,0,0,0,0,0,0,0,0,1,1,1,0,30,30,0,0,0
208,208,207,209,210,211,0,0,0,0,0,0,0,0,1,1,1,0,30,30,0,0,0
209,209,208,210,211,212,0,0,0,0,0,0,0,0,1,1,1,0,30,30,0,0,0
210,210,209,211,212,213,0,0,0,0,0,0,0,0,1,1,1,0,30,30,0,0,0
211,211,210,212,213,214,0,0,0,0,0,0,0,0,1,1,1,0,30,30,0,0,0
212,212,211,213,214,215,0,0,0,0,0,0,0,0,1,1,1,0,30,30,0,0,0
213,213,212,214,215,216,0,0,0,0,0,0,0,0,1,1,1,0,30,30,0,0,0
214,214,213,215,216,217,0,0,0,0,0,0,0,0,1,1,1,0,30,30,0,0,0
215,215,214,216,217,218,0,0,0,0,0,0,0,0,1,1,1,0,30,30,0,0,0
216,216,215,217,218,219,0,0,0,0,0,0,0,0,1,1,1,0,30,30,0,0,0
217,217,216,218,219,220,0,0,0,0,0,0,0,0,1,1,1,0,30,30,0,0,0
218,218,217,219,220,221,0,0,0,0,0,0,0,0,1,1,1,0,30,30,0,0,0
219,219,218,220,221,222,0,0,0,0,0,0,0,0,1,1,1,0,30,30,0,0,0
220,220,219,221,222,223,0,0,0,0,0,0,0,0,1,1,1,0,30,30,0,0,0
221,221,220,0,223,224,0,0,0,0,0,0,0,0,0.929,1,1,0,30,30,0,0,0
264,264,2,333,3,272,0,0,0,0,0,0,0,0,1,1,1,0,30,30,0,0,0
265,265,2,335,3,273,0,0,0,0,0,0,0,0,1,1,1,0,30,30,0,0,0
266,266,334,332,342,274,0,0,0,0,0,0,0,0,1,1,1,0,30,30,0,0,0
267,267,332,330,340,275,0,0,0,0,0,0,0,0,1,1,1,0,30,30,0,0,0
268,268,331,328,339,276,0,0,0,0,0,0,0,0,0.999,1,1,0,30,30,0,0,0
269,269,329,270,337,277,0,0,0,0,0,0,0,0,1,1,1,0,30,30,0,0,0
270,270,269,271,277,278,0,0,0,0,0,0,0,0,1,1,1,0,30,30,0,0,0
271,271,270,272,278,279,0,0,0,0,0,0,0,0,1,1,1,0,30,30,0,0,0
272,272,271,273,279,280,0,0,0,0,0,0,0,0,1,1,1,0,30,30,0,0,0
273,273,272,274,280,281,0,0,0,0,0,0,0,0,1,1,1,0,30,30,0,0,0
274,274,273,275,281,282,0,0,0,0,0,0,0,0,1,1,1,0,30,30,0,0,0
275,275,274,276,282,283,0,0,0,0,0,0,0,0,1,1,1,0,30,30,0,0,0
276,276,275,277,283,284,0,0,0,0,0,0,0,0,1,1,1,0,30,30,0,0,0
277,277,276,278,284,285,0,0,0,0,0,0,0,0,1,1,1,0,30,30,0,0,0
278,278,277,279,285,286,0,0,0,0,0,0,0,0,1,1,1,0,30,30,0,0,0
279,279,278,280,286,287,0,0,0,0,0,0,0,0,1,1,1,0,30,30,0,0,0
280,280,279,281,287,288,0,0,0,0,0,0,0,0,1,1,1,0,30,30,0,0,0
281,281,280,282,288,289,0,0,0,0,0,0,0,0,1,1,1,0,30,30,0,0,0
282,282,281,283,289,290,0,0,0,0,0,0,0,0,1,1,1,0,30,30,0,0,0
283,283,282,284,290,291,0,0,0,0,0,0,0,0,1,1,1,0,30,30,0,0,0
284,284,283,285,291,292,0,0,0,0,0,0,0,0,1,1,1,0,30,30,0,0,0
285,285,284,286,292,293,0,0,0,0,0,0,0,0,1,1,1,0,30,30,0,0,0
286,286,285,287,293,294,0,0,0,0,0,0,0,0,1,1,1,0,30,30,0,0,0
287,287,286,288,294,295,0,0,0,0,0,0,0,0,1,1,1,0,30,30,0,0,0
288,288,287,289,295,296,0,0,0,0,0,0,0,0,1,1,1,0,30,30,0,0,0
289,289,288,290,296,297,0,0,0,0,0,0,0,0,1,1,1,0,30,30,0,0,0
290,290,289,291,297,298,0,0,0,0,0,0,0,0,1,1,1,0,30,30,0,0,0
291,291,290,292,298,299,0,0,0,0,0,0,0,0,1,1,1,0,30,30,0,0,0
292,292,291,293,299,300,0,0,0,0,0,0,0,0,1,1,1,0,30,30,0,0,0
293,293,292,294,300,301,0,0,0,0,0,0,0,0,1,1,1,0,30,30,0,0,0
294,294,293,295,301,302,0,0,0,0,0,0,0,0,1,1,1,0,30,30,0,0,0
295,295,294,296,302,303,0,0,0,0,0,0,0,0,1,1,1,0,30,30,0,0,0
296,296,295,297,303,304,0,0,0,0,0,0,0,0,1,1,1,0,30,30,0,0,0
297,297,296,298,304,305,0,0,0,0,0,0,0,0,1,1,1,0,30,30,0,0,0
298,298,297,299,305,306,0,0,0,0,0,0,0,0,1,1,1,0,30,30,0,0,0
299,299,298,300,306,307,0,0,0,0,0,0,0,0,1,1,1,0,30,30,0,0,0
300,300,299,301,307,308,0,0,0,0,0,0,0,0,1,1,1,0,30,30,0,0,0
301,301,300,302,308,309,0,0,0,0,0,0,0,0,1,1,1,0,30,30,0,0,0
302,302,301,303,309,310,0,0,0,0,0,0,0,0,1,1,1,0,30,30,0,0,0
303,303,302,304,310,311,0,0,0,0,0,0,0,0,1,1,1,0,30,30,0,0,0
304,304,303,305,311,312,0,0,0,0,0,0,0,0,1,1,1,0,30,30,0,0,0
305,305,304,306,312,313,0,0,0,0,0,0,0,0,1,1,1,0,30,30,0,0,0
306,306,305,307,313,314,0,0,0,0,0,0,0,0,1,1,1,0,30,30,0,0,0
307,307,306,308,314,315,0,0,0,0,0,0,0,0,1,1,1,0,30,30,0,0,0
308,308,307,309,315,316,0,0,0,0,0,0,0,0,1,1,1,0,30,30,0,0,0
309,309,308,310,316,317,0,0,0,0,0,0,0,0,1,1,1,0,30,30,0,0,0
310,310,309,311,317,318,0,0,0,0,0,0,0,0,1,1,1,0,30,30,0,0,0
311,311,310,312,318,319,0,0,0,0,0,0,0,0,1,1,1,0,30,30,0,0,0
312,312,311,313,319,320,0,0,0,0,0,0,0,0,1,1,1,0,30,30,0,0,0
313,313,312,314,320,321,0,0,0,0,0,0,0,0,1,1,1,0,30,30,0,0,0
314,314,313,315,321,322,0,0,0,0,0,0,0,0,1,1,1,0,30,30,0,0,0
315,315,314,316,322,323,0,0,0,0,0,0,0,0,1,1,1,0,30,30,0,0,0
316,316,315,317,323,324,0,0,0,0,0,0,0,0,1,1,1,0,30,30,0,0,0
317,317,316,318,324,325,0,0,0,0,0,0,0,0,1,1,1,0,30,30,0,0,0
318,318,317,319,325,326,0,0,0,0,0,0,0,0,1,1,1,0,30,30,0,0,0
319,319,318,320,326,327,0,0,0,0,0,0,0,0,1,1,1,0,30,30,0,0,0
320,320,319,321,327,328,0,0,0,0,0,0,0,0,1,1,1,0,30,30,0,0,0
321,321,320,322,328,329,0,0,0,0,0,0,0,0,1,1,1,0,30,30,0,0,0
322,322,321,323,329,330,0,0,0,0,0,0,0,0,1,1,1,0,30,30,0,0,0
323,323,322,324,330,331,0,0,0,0,0,0,0,0,1,1,1,0,30,30,0,0,0
324,324,323,325,331,332,0,0,0,0,0,0,0,0,1,1,1,0,30,30,0,0,0
325,325,324,326,332,333,0,0,0,0,0,0,0,0,1,1,1,0,30,30,0,0,0
326,326,325,327,333,334,0,0,0,0,0,0,0,0,1,1,1,0,30,30,0,0,0
327,327,326,0,334,335,0,0,0,0,0,0,0,0,0.659,1,1,0,30,30,0,0,0
328,328,268,329,276,336,0,0,0,0,0,0,0,0,1,1,1,0,30,30,0,0,0
329,329,328,269,336,337,0,0,0,0,0,0,0,0,0.314,1,1,0,30,30,0,0,0
330,330,267,331,275,338,0,0,0,0,0,0,0,0,1,1,1,0,30,30,0,0,0
331,331,330,268,338,339,0,0,0,0,0,0,0,0,0.154,1,1,0,30,30,0,0,0
332,332,266,267,274,340,0,0,0,0,0,0,0,0,0.933,1,1,0,30,30,0,0,0
333,333,264,334,272,341,0,0,0,0,0,0,0,0,1,1,1,0,30,30,0,0,0
334,334,333,266,341,342,0,0,0,0,0,0,0,0,0.841,1,1,0,30,30,0,0,0
335,335,265,336,273,343,0,0,0,0,0,0,0,0,1,1,1,0,30,30,0,0,0
336,336,335,337,343,344,0,0,0,0,0,0,0,0,1,1,1,0,30,30,0,0,0
337,337,336,338,344,345,0,0,0,0,0,0,0,0,1,1,1,0,30,30,0,0,0
338,338,337,339,345,346,0,0,0,0,0,0,0,0,1,1,1,0,30,30,0,0,0
339,339,338,340,346,347,0,0,0,0,0,0,0,0,1,1,1,0,30,30,0,0,0
340,340,339,341,347,348,0,0,0,0,0,0,0,0,1,1,1,0,30,30,0,0,0
341,341,340,342,348,349,0,0,0,0,0,0,0,0,1,1,1,0,30,30,0,0,0
342,342,341,343,349,350,0,0,0,0,0,0,0,0,1,1,1,0,30,30,0,0,0
343,343,342,344,350,351,0,0,0,0,0,0,0,0,1,1,1,0,30,30,0,0,0
344,344,343,345,351,352,0,0,0,0,0,0,0,0,1,1,1,0,30,30,0,0,0
345,345,344,346,352,353,0,0,0,0,0,0,0,0,1,1,1,0,30,30,0,0,0
346,346,345,347,353,354,0,0,0,0,0,0,0,0,1,1,1,0,30,30,0,0,0
347,347,346,348,354,355,0,0,0,0,0,0,0,0,1,1,1,0,30,30,0,0,0
348,348,347,349,355,356,0,0,0,0,0,0,0,0,1,1,1,0,30,30,0,0,0
349,349,348,350,356,357,0,0,0,0,0,0,0,0,1,1,1,0,30,30,0,0,0
350,350,349,351,357,358,0,0,0,0,0,0,0,0,1,1,1,0,30,30,0,0,0
351,351,350,352,358,359,0,0,0,0,0,0,0,0,1,1,1,0,30,30,0,0,0
352,352,351,353,359,360,0,0,0,0,0,0,0,0,1,1,1,0,30,30,0,0,0
353,353,352,354,360,361,0,0,0,0,0,0,0,0,1,1,1,0,30,30,0,0,0
354,354,353,355,361,362,0,0,0,0,0,0,0,0,1,1,1,0,30,30,0,0,0
355,355,354,356,362,363,0,0,0,0,0,0,0,0,1,1,1,0,30,30,0,0,0
356,356,355,357,363,364,0,0,0,0,0,0,0,0,1,1,1,0,30,30,0,0,0
357,357,356,358,364,365,0,0,0,0,0,0,0,0,1,1,1,0,30,30,0,0,0
358,358,357,359,365,366,0,0,0,0,0,0,0,0,1,1,1,0,30,30,0,0,0
359,359,358,360,366,367,0,0,0,0,0,0,0,0,1,1,1,0,30,30,0,0,0
360,360,359,361,367,368,0,0,0,0,0,0,0,0,1,1,1,0,30,30,0,0,0
361,361,360,362,368,369,0,0,0,0,0,0,0,0,1,1,1,0,30,30,0,0,0
362,362,361,363,369,370,0,0,0,0,0,0,0,0,1,1,1,0,30,30,0,0,0
363,363,362,364,370,371,0,0,0,0,0,0,0,0,1,1,1,0,30,30,0,0,0
364,364,363,365,371,372,0,0,0,0,0,0,0,0,1,1,1,0,30,30,0,0,0
365,365,364,366,372,373,0,0,0,0,0,0,0,0,1,1,1,0,30,30,0,0,0
366,366,365,367,373,374,0,0,0,0,0,0,0,0,1,1,1,0,30,30,0,0,0
367,367,366,368,374,375,0,0,0,0,0,0,0,0,1,1,1,0,30,30,0,0,0
368,368,367,369,375,376,0,0,0,0,0,0,0,0,1,1,1,0,30,30,0,0,0
369,369,368,0,376,377,0,0,0,0,0,0,0,0,0.8,1,1,0,30,30,0,0,0
370,370,0,371,1,378,0,0,0,0,0,0,0,0,1.439,1,1,0,30,30,0,0,0
371,371,370,372,378,379,0,0,0,0,0,0,0,0,1.992,1,1,0,30,30,0,0,0
372,372,371,373,379,380,0,0,0,0,0,0,0,0,2.603,1,1,0,30,30,0,0,0
373,373,372,0,380,381,0,0,0,0,0,0,0,0,9.502,1,1,0,30,30,0,0,0
